{
    "matrix" :[
    [1, 1, 1, 1, 1, 1, 1, 1, 1, 1, 1, 1, 1, 1, 1, 1, 1, 1, 1, 1, 1, 1, 1, 1, 1, 1, 1, 1], 
    [1, 3, 2, 2, 2, 2, 2, 2, 2, 2, 2, 2, 2, 2, 2, 2, 2, 2, 2, 2, 2, 2, 2, 2, 2, 2, 3, 1], 
    [1, 2, 0, 0, 0, 0, 0, 0, 0, 0, 0, 0, 0, 0, 0, 0, 0, 0, 0, 0, 0, 0, 0, 0, 0, 0, 2, 1], 
    [1, 2, 0, 1, 1, 1, 1, 1, 1, 1, 1, 1, 1, 0, 0, 1, 1, 1, 1, 1, 1, 1, 1, 1, 1, 0, 2, 1], 
    [1, 2, 0, 1, 3, 2, 2, 2, 2, 2, 2, 2, 2, 2, 2, 2, 2, 2, 2, 2, 2, 2, 2, 3, 1, 0, 2, 1], 
    [1, 2, 0, 1, 2, 0, 0, 0, 2, 0, 2, 0, 0, 0, 2, 0, 0, 2, 0, 2, 0, 0, 0, 2, 1, 0, 2, 1], 
    [1, 2, 0, 0, 2, 0, 1, 0, 2, 1, 2, 0, 1, 0, 2, 1, 0, 2, 1, 2, 0, 1, 0, 2, 0, 0, 2, 1], 
    [1, 2, 0, 0, 2, 0, 1, 0, 2, 1, 2, 0, 1, 0, 2, 1, 0, 2, 1, 2, 0, 1, 0, 2, 0, 0, 2, 1], 
    [1, 2, 0, 1, 2, 0, 1, 0, 2, 1, 2, 0, 1, 0, 2, 1, 0, 2, 1, 2, 0, 1, 0, 2, 1, 0, 2, 1], 
    [1, 2, 0, 1, 2, 0, 1, 0, 2, 1, 2, 0, 1, 0, 2, 1, 0, 2, 1, 2, 0, 1, 0, 2, 1, 0, 2, 1], 
    [1, 2, 0, 1, 2, 0, 1, 0, 2, 1, 2, 0, 1, 0, 2, 1, 0, 2, 1, 2, 0, 1, 0, 2, 1, 0, 2, 1], 
    [1, 2, 0, 1, 2, 0, 1, 0, 2, 1, 2, 0, 1, 0, 2, 1, 0, 2, 1, 2, 0, 1, 0, 2, 1, 0, 2, 1], 
    [1, 3, 0, 0, 0, 0, 0, 0, 0, 0, 0, 0, 0, 0, 0, 0, 0, 0, 0, 0, 0, 0, 0, 0, 0, 0, 3, 1], 
    [1, 0, 0, 0, 0, 0, 0, 0, 0, 0, 0, 0, 0, 0, 0, 0, 0, 0, 0, 0, 0, 0, 0, 0, 0, 0, 0, 1], 
    [1, 1, 1, 0, 2, 2, 2, 2, 2, 2, 2, 0, 0, 0, 0, 0, 0, 0, 2, 2, 2, 2, 2, 2, 2, 1, 1, 1], 
    [1, 3, 0, 0, 2, 2, 2, 2, 2, 2, 2, 0, 0, 0, 0, 0, 0, 0, 2, 0, 0, 0, 0, 0, 2, 0, 3, 1], 
    [0, 2, 0, 0, 2, 2, 2, 2, 2, 2, 2, 0, 7, 0, 0, 0, 7, 0, 2, 0, 2, 0, 2, 0, 2, 0, 2, 0], 
    [0, 2, 0, 0, 2, 2, 2, 2, 2, 2, 2, 0, 7, 0, 0, 0, 7, 0, 2, 0, 2, 0, 2, 0, 2, 0, 2, 0], 
    [1, 0, 0, 0, 2, 2, 2, 2, 2, 2, 2, 0, 7, 0, 0, 0, 7, 0, 2, 0, 0, 0, 0, 0, 2, 0, 0, 1], 
    [1, 1, 1, 0, 2, 2, 2, 2, 2, 2, 2, 0, 7, 7, 7, 7, 7, 0, 2, 2, 2, 2, 2, 2, 2, 1, 1, 1], 
    [1, 3, 0, 0, 0, 0, 0, 0, 0, 0, 0, 0, 0, 0, 0, 0, 0, 0, 0, 0, 0, 0, 0, 0, 0, 0, 3, 1], 
    [1, 2, 0, 0, 0, 0, 0, 0, 0, 0, 0, 0, 0, 0, 0, 0, 0, 0, 0, 0, 0, 0, 0, 0, 0, 0, 2, 1], 
    [1, 2, 0, 1, 1, 1, 1, 2, 2, 1, 1, 1, 1, 2, 2, 1, 1, 1, 1, 2, 2, 1, 1, 1, 1, 0, 2, 1], 
    [1, 2, 0, 2, 2, 2, 2, 2, 2, 2, 2, 2, 2, 2, 2, 2, 2, 2, 2, 2, 2, 2, 2, 2, 2, 0, 2, 1], 
    [1, 2, 0, 0, 0, 0, 0, 2, 2, 0, 0, 0, 0, 2, 2, 0, 0, 0, 0, 2, 2, 0, 0, 0, 0, 0, 2, 1], 
    [1, 2, 0, 1, 1, 1, 1, 2, 2, 1, 1, 1, 1, 2, 2, 1, 1, 1, 1, 2, 2, 1, 1, 1, 1, 0, 2, 1], 
    [1, 2, 0, 1, 0, 0, 1, 2, 2, 1, 0, 0, 1, 2, 2, 1, 0, 0, 1, 2, 2, 1, 0, 0, 1, 0, 2, 1], 
    [1, 2, 0, 1, 1, 1, 1, 2, 2, 1, 1, 1, 1, 2, 2, 1, 1, 1, 1, 2, 2, 1, 1, 1, 1, 0, 2, 1], 
    [1, 3, 2, 2, 2, 2, 2, 2, 2, 2, 2, 2, 2, 2, 2, 2, 2, 2, 2, 2, 2, 2, 2, 2, 2, 2, 3, 1], 
    [1, 0, 0, 0, 0, 0, 0, 0, 0, 0, 0, 0, 0, 0, 0, 0, 0, 0, 0, 0, 0, 0, 0, 0, 0, 0, 0, 1], 
    [1, 1, 1, 1, 1, 1, 1, 1, 1, 1, 1, 1, 1, 1, 1, 1, 1, 1, 1, 1, 1, 1, 1, 1, 1, 1, 1, 1]],
    
    "dots":273,
    "powers":8,
    "rows":31,
    "cols":28,
    "pacman_start_pos":[1, 1]
    
}